NO ./imgs/Wall.xpm 
SO ./imgs/Wall2.xpm
WE ./imgs/blust.xpm
EA ./imgs/wood.xpm

F 20,100,100
C 125,30,100

1111111111111111111111111
1000000000110000000000001
1011000001110000000000001
1101000000000000000000001
11111111100E0001110000000000001
1000000000000001110111111111111
11110111111111011100000010001
11110111111111011101010010001
11000000110101011100000010001
10000000000000001100000010001
10000000000000001101010010001
1100000111010101111101111000111
11111111 1111111 111111111111   